#Wed Nov 15 11:52:19 CET 2023
AboutOpenLCA=关于 openLCA
AccessAndUseRestrictions=访问和使用限制
Active=激活
ActivityQuantity=活动数据质量
ActivityUnit=活动单位
ActivityVariable=活动变量
Actor=参与者
Actors=参与者们
Add=增加
AddedValue=增加数值
AddIndicator=添加新指标
AddInputFlow=增加输入流
AdditionalInformation=附加信息
AddNewChildCategory=增加新的子类别
AddNewRepository=添加新仓库
AddOutputFlow=增加输出流
AddProcess=增加过程
Address=地址
AddScore=添加新评分
AddSection=增加区块
AddStickyNote=添加便签
AddToMethodParameters=增加方法的参数
AdministrativeInformation=管理信息
Aggregation=合计
AggregationType=合计类型
Allocation=分配
AllocationFactors=分配要素
AllocationMethod=分配方法
ALocationCodeIsRequired=位置编码为必填
AlreadyConnected=已连接
AlreadyPresent=已存在
Amount=数量
Analysis=分析
AnalysisResultOf=分析结果
AnalyzingForProblems=分析问题
ApplyFormat=应用格式
ApplyingDatabaseUpdates=应用数据库更新
AreYouSureYouWantToCheckout=您确定要检出所选提交吗？此操作将覆盖您当前的数据库状态并且无法撤销。
ArithmeticMean=算术平均值
AsDefinedInProcesses=如过程中定义
AssessDataQuality=评估数据质量
AssignUnits=指定单位
Authentication=认证
AutoLinkProcesses=自动链接过程
AvoidedProduct=避免产品
AvoidedProductFlow=避免生产流
AvoidedWaste=避免浪费
AvoidedWasteFlow=避免废物流
BackgroundData=背景数据
BackupDatabase=备份数据库
BaseUncertainty=不确定性
Both=两者
Browse=浏览
BrowseLocalFiles=浏览本地文件...
BuildFlowSupplyChain=构建流供应链
BuildNextTier=建立下一层
BuildSupplyChain=建立供应链
Bulkreplace=批量替换
BulkreplaceFlows=批量替换流
BulkreplaceProviders=批量替换供应者
Calculate=计算
CalculateCosts=计算成本
CalculateDefaultValues=计算默认值
CalculateResults=计算结果
CalculateStatistics=计算统计
CalculationProperties=计算特性
CalculationType=计算类型
CalculationWizardDescription=请选择要计算的特性
Cancel=取消
CannotDelete=无法删除
CannotDeleteFlowProperty=无法删除流属性
CannotDeleteMessage=所选择的组件无法删除，它已经被使用于其他数据组合，请查询它在哪里已被使用。
CannotDeleteReferenceFlowProperty=不能删除参考的流特性
CannotDeleteReferenceUnit=无法删除参考的单位
CannotDeleteRefFlow=无法删除参考流
CannotDeleteRefFlowMessage=无法删除过程中参考的流
CannotDeleteUnit=无法删除单位
CannotRemoveExchanges=无法移除交换数据
CannotRemoveSupplyChain=无法移除供应链
CanNotSaveParameter=无法保存参数，可能公式内容错误
CASNumber=CAS编号
Category=类别
CategoryNotEmpty=类别不为空
Causal=因果
CausalAllocation=因果的分配
Change=改变
CheckingOutCommit=检出已提交
CheckLinkingProperties=检查链接属性
Checkout=检出...
ChooseDirectory=选择目录...
City=城市
Clear=清除
ClearData=清除数据
ClickHereToChangeDisplay=点击这里变更显示
Close=关闭
CloseAll=关闭所有
CloseDatabase=关闭数据库
Code=邮政编码
Collapse=折叠
CollapseAll=折叠全部
ColumnSeparator=分隔栏位
Comma=逗号
Comment=评论
Comments=评论
Commit=提交…
CommitAndPush=提交并推送
CommitChangesToRepository=提交变更至存储库
CommitDate=提交日期
CommitError=接收提交数据时发生错误
CommitingChanges=提交变更
CommitMessage=提交信息
CommitReferenceNotice=需要先提交后才能引用所有变更
Committer=提交者
Compare=比较
CompareWith=与...比较
ComparingWithRepository=比较存储库
Complete=完成
CompleteReferenceData=完成参考的数据
Component=组件
Compress=压缩
CompressDatabase=压缩数据库
CompressingDatabase=正在压缩数据库...
Configuration=配置
ConfigureEcospoldMessage=此页你能配置导出EcoSpold格式
ConfigureRepositories=配置仓库
Connect=连接
ConnectingToRepository=连接到存储库
Connection=连接
ConnectionFailed=连接失败
ConnectionWithAnonymousAccess=允许匿名访问的连接
ConnectProviders=连接提供者
ConnectRecipients=连接接收者
ConsumedBy=消耗
Content=内容
Context=背景
Contribution=贡献
ContributionTree=贡献树状图
ContributionTreeLocations=贡献树状图位置
ConversionFactor=转换因素
Copy=复制
CopyAllFromRightToLeft=从右边复制至左边
CopyMetaDataFromReferenceProcess=从参考过程复制元数据
Copyright=版权所有
CopySelectionFromRightToLeft=复制右边已选择至左边
CostCategory=成本类别
CostFormula=成本计算公式
CostResult=成本结果
Costs=成本
CostsPerUnit=单位成本
CostsRevenues=成本/收入
CostValue=成本价值
CouldNotAllocateMemoryError=openLCA无法定址到更多的内存去进行计算。请调整你的内存设置( 文件/偏好 -> 设置)
CouldNotConnect=无法连接，请检查您的互联网连接和提供的url
CouldNotFindKMLData=你提供的文件无法找到KML数据，您确定它是EcoSpold2格式吗？更详细信息可以前往http://www.ecoinvent.org/data-providers/how-to-submit-data/ecospold2了解。
CouldNotOpenDatabase=无法打开数据库
CouldNotOverwriteFile=无法覆写文件
Country=国家
Coverage=范围
CreateANewDatabase=建立新数据库
CreateANewFlowForTheProcess=为过程创建一个新流（作为定量参考）
CreateANewProductFlowForTheProcess=建立过程的生产流
CreateAWasteTreatmentProcess=创建废物处理过程
CreateDatabase=建立数据库
CreateDefaultValuesForMissingFields=替缺少数据建立预设值
CreateNew=建立新的
CreateProcess=建立过程
CreateProcesslink=建立过程链接
CreateProductSystem=建立产品系统
CreatesANewActor=建立新的参与者
CreatesANewDataQualitySystem=建立新的数据质量系统
CreatesANewFlow=建立新的流
CreatesANewFlowProperty=建立新的流特性
CreatesANewImpactMethod=建立新的影响评估方法
CreatesANewLocation=建立新的位置
CreatesANewParameter=建立新的参数
CreatesANewProductSystem=建立新的生产系统
CreatesANewProject=建立新的方案
CreatesANewSource=建立新的来源
CreatesANewUnitGroup=建立新的单位群组
CreatingEcoSpoldFolder=建立ecoSpold目录
CreatingProductSystem=正建立生产系统
CreationDate=建立日期
CSVFormat=CSV格式
Currencies=货币
Currency=货币
CurrencyCode=货币代码
Cut=剪切
Cutoff=剪切
Database=数据库
DatabaseContent=数据库内容
DatabaseImport=数据库导入
DatabaseImportDescription=导入现有数据库内容至已开启的数据库
DatabaseName=数据库名称
DatabaseNewerThanThisError=你给的数据库比openLCA的版本还新
DatabaseRenameError=你给的名称是无效的或是数据库名称已存在
DatabaseType=数据库类型
DatabaseValidationCompleteNoErrorsWereFound=数据库完成验证，没有发现错误
DatabaseVersionCheckFailed=无法取得数据库版本，这是openLCA使用的数据库？
DatabaseWasExportedToFile=数据库已经汇至文件
DataCollectionPeriod=数据收集频率
DataCompleteness=数据完成度
DataDocumentor=数据文件人员
DataGenerator=数据产生人员
DataQuality=数据质量
DataQualityEntry=数据质量
DataQualityProperties=数据质量特性
DataQualitySystem=数据质量系统
DataQualitySystems=数据质量系统
DataSelection=数据挑选
DataSet=数据组合
DataSetOtherEvaluation=数据组其他评估
DataSetOwner=数据组合拥有者
DataSets=数据组合
DataSourceInformation=数据来源信息
DataTreatment=数据整理
DaysAgo=天前
DaysFromNow=天后
DBImportNoTarget=导入时需要打开目标数据库
DBImportNoTargetConnectionFailedMessage=无法取得来源数据库版本
DBImportUpdateDatabaseQuestion=导入数据库时必须更新来源数据库，你确定吗？
DBImportVersionNewerMessage=来源数据库版本比openLCA还新
DecimalSeparator=数字区隔
DefaultFlowProperty=预设流属性
DefaultMethod=预设方法
DefaultProvider=提供者
Delete=删除
DeleteCategoryQuestion=你确定要删除已选择的类别？
DeleteDatabase=删除数据库
DeleteFile=删除文件
DeleteLocalDataset=删除本地数据集
DeleteProcess=删除过程
DeleteProcesslink=删除过程链接
DeleteReportSectionQuestion=你确定要删除报告区块？
DeleteSection=删除区块
DeleteShapeFile=删除shape文件
DependenantParameter=依赖参数
DependentParameter=依赖参数
DependentParameters=依赖的参数
Description=内容
DeveloperTools=开发者工具
Direct=直接
DirectContribution=直接贡献
DirectContributionsFlowResultsOverview=直接贡献流-概览
DirectContributionsImpactCategoryResultsOverview=直接贡献影响类别的结果-概览
Direction=方向
Disabled=禁用
Disconnect=断开连接
Display=显示
DoNotShowThisMessageAgain=不再显示此消息
DontShowSmallerThen=不显示小于<
Dot=点
DownloadingData=下载数据...
DoYouReallyWantToDelete=你确定要删除？
East=东
Economic=经济
EcoSpold2Export=导出至EcoSpold 2
EcoSpoldConfiguration=EcoSpold设置
Edit=编辑
EditFlow=编辑流
EditMode=编辑模式
EditStickyNote=编辑便签
ElementaryFlow=基本流
Email=电子邮箱
EmailOrUsername=用户名或电子邮件
EmptyDatabase=空数据库
EmptyValueMessage=输入值为空
EnableCollaboration=启用协作
EnableComments=启用评论
EnableJblasLibrary=启用jblas函数库
EndDate=结束日期
EnterLocationNameAndCode=请在新的位置输入名称及邮编
EnterYourAuthenticatorToken=输入您的验证器令牌
Error=错误
ErrorPopupMessage=打开log文件了解更多信息
ErrorPopupTitle=发生异常错误
Errors=错误
EstimatedTimeRemaining=预计剩余时间: 
EvaluateAllFormulas=评估所有公式
EvaluateLocations=评估位置
EvaluatingLocations=评估位置中
EvaluationSchema=评估格式
Example=例子
ExcelExport=导出至Excel文件
ExchangeDataQualitySchema=交换数据质量格式
ExchangesAreUsed=选择的交换数据已经被使用在生产系统中，无法被删除
ExchangesAreUsedOrNotDisconnected=一个或多个选定的交换已在产品系统中使用或在此产品系统中没有完全断开，因此无法删除。
ExcludeExchangesWithDefaultProviders=排除默认交换提供者
ExcludeZeroEntries=排除空项目
ExcludeZeroValues=排除零值
Exit=退出
Expand=展开
ExpandAll=展开全部
Expired=已过期
ExpiryDate=到期日期
Export=导出...
ExportAsMatrix=导出矩阵
ExportDatabase=导出数据库
ExportDataSets=导出数据组合
ExportDataSetsInOneFile=导出所有的数据组合至单一文件
ExportDirectory=导出至目录
ExportDone=导出完成
ExportEcoSpold=导出EcoSpold
ExportILCD=导出ILCD
ExportingProcesses=导出处理中
ExportMatrix=导出矩阵
ExportProcess=导出过程
ExportReport=导出报告
ExportResults=导出结果
ExportResultsToExcel=导出结果至Excel
ExportToExcel=导出至Excel
ExternalFile=外部文件
ExternalSource=外部来源
ExternalSourceChange=改变外部来源
Factor=因子
Factors=因子
FailedToLoadFlowProperty=无法加载流属性
Fetch=提取...
FetchingChanges=提取所有变更
FetchingCommits=提取所有提交
FetchingData=提取数据
File=文件(&F)
FileAlreadyExists=文件已经存在
FileDoesNotExist=文件不存在
FileImportPage_Description=请选择要导入的文件
Files=文件
Filter=筛选
FilterByName=名称筛选
Flow=流
FlowContributions=流贡献
FlowContributionsToProcessResults=流贡献至过程结果
FlowDataQualitySchema=流数据质量图解
FlowDataQualityStatistics=流数据质量统计
FlowProperties=流特性
FlowProperty=流特性
FlowPropertyIsUsed=此流特性已经存在于过程或影响评估方法中
FlowPropertyType=流特性类型
Flows=流
FlowSchema=流图解
FlowType=流类型
Focus=焦点
Folder=目录
Formula=公式
FormulaEvaluationFailed=公式评估失败
FormulaInterpreter=公式解释器
FoundProblems=发现问题:
FromDirectory=从目录:
Function=功能
GeneralDatabaseProperties=常规数据库属性
GeneralInformation=基本信息
Generator=生成器
Geography=地理信息
GeographyDescription=地理信息内容
GeometricMean=几何平均数
GeometricMeanFormula=几何平均数（公式）
GeometricStandardDeviation=几何标准偏差
GeometricStandardDeviationFormula=几何标准偏差（公式）
Geometry=几何
Global=全球性的
GlobalParameter=全局性参数
GlobalParameters=全局性参数
GoalAndScope=目的和范围
Group=群组
Grouping=群组
Groups=群组
HalfUp=四舍五入
HasInventoryResult=具有库存结果
HasUncertainties=有不确定因素
HEADRevision=HEAD标记的修订版本
Help=帮助(&H)
Hide=隐藏
HideExecutedUpdates=隐藏已执行更新
HighOpportunity=高机率
HighRisk=高风险
Home=首页
Host=主机
HTMLGraph=HTML图表
Id=ld
IgnoreDefaultProviders=忽略默认提供者
ILCD_AUTHENTICATION_FAILED_MSG=验证失败，请检查名称和密码是否正确
ILCD_CONNECTION_FAILED_MSG=连接失败，请检查网络连接、网址、用户资料是否正确
ILCD_CONNECTION_WORKS_MSG=连接正常
ILCD_NetworkImport=网络导入
ILCD_NO_READ_OR_WRITE_ACCESS_MSG=没有读或写的权限
ILCD_RunImport=开始导入
ILCD_SearchFailedMessage=网络搜索失败
ILCD_SearchPageDescription=搜索或选择导入
ILCDNetworkExport=ILCD网络导出
ILCDNetworkExportDescription=导出过程或生产系统到ILCD网络
ILCDNetworkSettings=ILCD网络设置
ILCDOtherSettings=ILCD其他设置
ImageExport=导出图形
ImpactAnalysis=影响评估分析
ImpactAssessmentMethod=影响评估方法
ImpactAssessmentMethods=影响评估方法
ImpactAssessmentResults=影响评估结果
ImpactCategories=影响评估类别
ImpactCategory=影响评估类别
ImpactFactor=影响因素
ImpactFactors=影响因素
ImpactMethod=影响方法
ImpactResult=影响结果
ImpactResults=影响结果
Import=导入...
ImportData=导入资料
ImportDatabase=导入数据库
ImportEcoSpold=导入 EcoSpold
ImportEcoSpold01DataSets=导入 EcoSpold01 数据组合
ImportEcoSpold02DataSets=导入 EcoSpold02 数据组合
ImportEcoSpoldGeographies=导入 EcoSpold2 坐标
ImportILCD=导入 ILCD
ImportingKMLData=导入 KML 资料
ImportingXMLData=导入 XML (EcoSpold2格式) 资料
ImportKMLGeographies=导入 KML 坐标
ImportRemoteDataset=导入远程数据集
IncludeCostCalculation=引入费用计算
IndexingDatasets=索引数据集
Indicator=指标
IndicatorBarChart=指标柱状图
Indicators=指标
IndicatorsAndParameters=指标及参数
IndicatorsScores=指标与分数
Information=信息
InfrastructureFlow=基础流
InfrastructureProcess=基础过程
Initializing=初始化
Input=输入
InputOutput=输入/输出
InputParameter=输入参数
InputParameters=输入参数
InputResults=库存结果（资源）
Inputs=输入
InputsOutputs=输入/输出
IntendedApplication=预期的应用
InterventionMatrix=干预矩阵
InvalidAllocationFactor=无效的因数
InvalidAllocationFactorMessage=分配因数的值介于0到1
InvalidFormula=无效的公式
InvalidMemoryValue=无效的记忆体值
InvalidNumber=无效的编号
InvalidParameterName=无效的参数名称
InvalidValue=无效的值
Inventory=盘查
InventoryResult=盘查结果
InventoryResults=盘查结果
IsBaseline=是否基线
IsDefault=为默认
IsDefaultProvider=是否默认提供者
IsDisabled=是否禁用
IsInvalidFormula=是无效的公式
IsNotValidNumber=是无效的编号
IsNotValidParameterName=是无效的参数名称
IsProtected=是否受保护
IsReference=是参考信息
IsWithCosts=是否包含成本
IsWithRegionalization=是否包含区域化
KeepDatasetDeleted=保持数据集删除
KeepLocalDataset=保留本地数据集
KmlEditor=KML 编辑
Label=标签
Language=语言
LastChange=上次修改
Latitude=纬度
Layout=版面配置
LayoutAs=版面配置为{0}
LCCAddedValuesTable=LCC: 表格值已加入
LCCNetcostsTable=LCC: 净成本表格
LciaCategoryDescriptionTable=LCIA 类别说明表格
LCIAChecks=LCIA检查
LCIAMethod=LCIA 方法
LciaResultTable=LCIA 结果表格
LCIMethod=LCIA 方法
LibgfortanInfo=openLCA使用jblas函数库验证计算性能，使用Linux必须要安装libgfortran3套件，如果你使用Ubuntu可以利用命令安装套件'apt-get install libgfortran3'
Library=库
LicenseCorrupted=库已损坏（一些文件被修改或删除）
LicenseExpired=库许可证已过期。
LicenseInformation=许可证信息
LicenseNotYetValid=库许可证尚未生效。
LicenseUntrusted=库许可证不是由受信任的证书颁发机构颁发的。
LicenseValid=库许可证有效。
LicenseWrongPassword=提供的密码错误。
LicenseWrongUser=提供的用户错误。
Line=行
LinkingProperties=链接属性
LoadingRepositoryList=正在加载仓库列表
Local=本地
LocalDatabase=本地数据库
Location=位置
Locations=位置
LogFile=记录文件
LogNormalDistribution=对数正态分析
Longitude=经度
LowOpportunity=低机率
LowRisk=低风险
ManagePlugins=管理插件
Manufacturer=制造商
Map=地图
MapCanNotBeDisplayed=无法显示地图，您是否有活跃的互联网连接？
Mark=标记
MarkAsMerged=标记为合并
MatrixExport=矩阵导出
MatrixFiles=矩阵文件
Maximize=最大化
MaximizeAll=全部最大化
Maximum=最大
MaximumFormula=最大（公式）
MaximumMemoryUsage=记忆体使用量(MB计算)
Mean=平均
MeanFormula=平均（公式）
MediumOpportunity=中度机率
MediumRisk=中度风险
MemoryToHighMessage=记忆体使用量太高
MemoryToLowMessage=记忆体需求至少256MB
Merge=合并
Message=消息
Methods=方法
MinimalTree=最小化树状
Minimap=小地图
Minimize=最小化
MinimizeAll=全部最小化
Minimum=最小
MinimumFormula=最小（公式）
Mode=模型
ModeFormula=模型（公式）
ModelGraph=模型图表
ModelingAndValidation=建模和验证
ModelingConstants=建模常数
ModelType=模型类型
Modules=模块
MonteCarloSimulation=蒙特卡洛模拟
MoreThanXProcesses=将显示超过2000个过程，这需要一段时间。仍然继续吗？
Move=移动
MoveDown=向下移
MoveUp=向上移
MultiLine=多行
MultiPoint=多点
MultiPolygon=多边形
Name=名称
NameCannotBeEmpty=名称不能为空
NameShouldBeDifferent=名称必须不一样
NaValueHandling=未知数值处理
NeedOpenDatabase=打开数据库
Netcosts=净成本
NetCosts=净成本
NewActor=新参与者
NewCategory=新类别
NewCurrency=新货币
NewDatabase_AlreadyExists=数据库名称已存在
NewDatabase_InvalidName=名称内容包含无效内容（允许：英文、数字）
NewDatabase_NameToShort=数据库名称长度必须大于4
NewDatabase=新数据库
NewDataQualitySystem=数据质量系统
NewFlow=新流
NewFlowProperty=新流特性
NewImpactCategory=新影响评估方法类别
NewImpactMethod=新影响评估方法
NewLCIAMethod=新LCIA方法
NewLocation=新位置
NewParameter=新参数
NewProcess=新过程
NewProductSystem=新生产系统
NewProject=新项目
NewSection=新区块
NewSocialIndicator=新社会指标
NewSource=新来源
NewUnitGroup=新单位组
No=否
NoAccessToRepository=存储库不存在或没有权限
NoAnalysisOptionsSet=没有分析选项
NoChangesInLocalDb=本地数据库没有变更
NoData=没有数据
NoDatabaseOpened=没有打开数据库
NoDescription=没有说明
NoDistribution=没有分布
NoExportFilesSelected=没有选择导出的文件
NoLicenseDetected=未检测到许可证。
None=无
NoOpportunity=无机会
NoParameterSelected=没有选择参数
NoProjectVaraintsAreDefined=没有定义项目变量
NoQuantitativeReferenceSelected=没有选择参考数量
NoReferenceFlowPropertySelected=没有选择参考流
NoReferenceProcessSelected=没有选择参考过程
NoReferenceSet=没有设置参照
NoRegionalizedInformation_Message=此系统没有可用的区域化信息
NoRisk=没有风险
NormalDistribution=正态分布
NormalisationBarChart=标准化条形图
NormalisationRadarChart=标准化雷达图
NormalisationResultTable=标准化结果表格
Normalization=标准化
NormalizationAndWeightingSet=标准化和加权集
NormalizationValue=标准化值
NormalizationWeighting=标准化和加权
NormalizationWeightingSets=标准化和加权组合
North=北
NoShapefileParameterSelected=没有选择shape文件参数能被加入参数方法
NotAnIntegerNumber=输入的值并非整数
NotApplicable=不适用
Note=笔记
NoteDefaultProviders=注：已有的提供者无法符合时会被默认提供者替代。勾选上面可以防止提供者被默认提供者替代
Notification=通知
NoUnitGroupSelected=没有选择单位组
NumberFormatPage_Description=设置显示数字的小数点位数
NumberOfDecimalPlaces=小数点位数
NumberOfIterations=重复次数
NumberOfSimulations=模拟次数
OfProduct=为产品
OK=确定
OnlineHelp=在线帮助
OnlyLinkDefaultProviders=仅链接默认提供者
Open=开启
OpenDatabase=开启数据库
OpenEditor=开启编辑器
OpenFlow=打开流
OpenInEditor=在编辑器中开启
OpenLCALog=记录文件
OpenLogFile=开启记录文件
OpenPluginManager=开启插件管理
OpenProvider=打开提供者
OpenUpdateManager=打开更新管理器
Organisation=组织
Other=其他
OutOfMemory=内存不足
Output=输出
OutputResults=库存结果（排放）
Outputs=输出
OverwriteFile=覆写文件
OverwriteFileQuestion=选中的文件已经存在，你确定要覆写它吗？
OverwriteLocalChanges=覆盖本地更改
OverwriteRemoteChanges=覆盖远程更改
Owner=所有者
Parameter=参数
ParameterAlreadyAdded=参数已经加入
ParameterDescriptionTable=参数内容表格
Parameters=参数
ParameterScope=参数范围
ParameterSets=参数集
ParameterValueTable=参数数值表格
ParameterWithSameNameExists=参数名称已经存在
ParameterWithSameNameExistsInMethod=参数名称在LCIA方法中已存在
Password=密码
Paste=粘贴
Pcr=PCR
PedigreeMatrix=系谱矩阵
PedigreeMatrixMessage=矩阵单元上点击项目
Physical=物理
PhysicalAndEconomicAllocation=物理和经济分配
PleaseEnterAName=请输入名称
PleaseEnterANewName=请输入新名称
PleaseEnterTheNameOfTheNewCategory=请输入新类别的名称：
PleaseEnterYourAuthenticatorTokenToProceed=请继续输入您的验证器令牌
PleaseEnterYourCredentialsLibrary=请输入您的凭证以打开库。
PleaseSelectElements=请选择您要导入的元素。如果未选择，所需的引用也将被加载。
PleaseSelectProperties=请选择数据质量评估的属性
PleaseSpecifyCompleteUrl=请指定要从中导入的仓库的完整url。如果仓库不是公开可访问的，您需要输入您的凭证以连接。
PleaseSpecifyHost=请指定主机
PleaseSpecifyPortNumber=请指定端口号码
PleaseSpecifyUser=请指定用户
Point=点
Polygon=多边形
Port=端口
Position=位置
Prefer=偏好：{0}
PreferDefaultProviders=优先选择默认提供者
Preferences=首选项
PreferredProcessType=首选过程类型
Preparing=准备中
Price=价格
Process=过程
ProcessContributionChart=过程贡献图
ProcessContributions=过程贡献
ProcessDataQualitySchema=过程数据质量图解
ProcessDataQualityStatistics=过程数据质量统计
ProcessDocumentation=过程文件
Processes=过程
ProcessesWithoutProviders=没有提供者的过程
ProcessEvaluationAndValidation=过程评估与验证
ProcessExcelImportDescription=从微软Excel导入过程
ProcessLinks=过程链接
ProcessResults=过程结果
ProcessSchema=过程图解
ProcessType=过程类型
ProducedBy=生产者
Product=生产
ProductFlowSupplyReference=产品流供应产品系统的参考
ProductSystem=生产系统
ProductSystemExcelExport=生产系统Excel导出
ProductSystemExcelExportMessage=请选择导出生产系统的目录
ProductSystems=生产系统
ProductSystemStatistics=生产系统统计
ProgramOperator=程序操作员
Progress=过程
Project=方案
Projects=方案
ProjectSetup=方案设置
Properties=特性
Provider=提供者
ProviderLinking=提供者链接
Providers=提供者
Publication=发布
Pull=拉取
Push=推送
QuantitativeReference=数量参考
Quantity=数量
QuickResults=快速结果
RawValue=原始值
ReallyDeleteShapeFile=你确定要删除选择的shape文件？所有的变更会被自动保存。
RebuildIndex=重建索引
RebuildingIndex=正在重建索引
RecalculateQuestion=所有值将会被重新计算，你确定要执行？
ReconnectProcesslink=重新连接过程链接
Reference=参考
ReferenceCurrency=参考的货币
ReferenceFlowProperty=流特性的参考
ReferenceFlowPropertyCannotBeDeleted=流特性的参考不能被删除
ReferenceProcess=参考的过程
ReferenceUnit=参考的单位
ReferenceUnitCannotBeDeleted=群组中参考的单位不能被删除
ReferenceUnitIsEmptyOrInvalid=参考的单位为空白或无效的
RegionalizedLCIA=LCIA 地区
RejectMessage=请求拒绝，请提取存储库最后的更新
RelativeLciaResultsBarChart=相应的 LCIA 结果 - 柱状图
RelativeLciaResultsRadarChart=相应的 LCIA 结果 - 雷达图
Reload=重新载入
Remote=远端
RemoteDatabase=远端数据库
Remove=移除
RemoveConnections=移除连线
RemoveFlowSupplyChain=移除流供应链
RemoveIndicator=移除指标
RemoveObject=移除对象
RemoveScore=移除评分
RemoveSelected=移除已选择的
RemoveSupplyChain=移除供应链
Rename=更名
ReplaceFlow=取代流
ReplaceIn=替换于
ReplaceProvider=取代提供者
Report=报告
ReportName=报告标签
ReportSections=报告区块
ReportView=报告浏览
Repository=仓库
RepositoryImport=仓库导入
RepositoryPath=仓库路径
Reset=重新设置
ResetAll=全部重新设置
ResetSelection=重新设置区块
Resize=调整大小
RestoreDatabase=恢复数据库
Restriction=限制
Result=结果
Results=结果
ResultsOf=结果的
ResultsOfProject=项目的结果
Reviewer=检阅人
RiskLevel=风险层级
RoundingMode=进位模式
Route=路径
RoutingEnabled=启用路由
RunCalculation=开始计算
SamplingProcedure=取样步骤
Sankey_ScaleDescription=过程颜色(贡献度百分比%)
SankeyDiagram=桑基图表
Save=存档
SaveAll=保存全部
SaveAs=另存为...
SaveAsImage=另存为图档
SaveAsLCIResult=保存为LCI结果
SaveChanges=储存所有变更
SaveChangesQuestion=你确定储存所有变更
SavingDiagramAsImageIn=储存图表为图档在{0}
ScanningRepository=扫描仓库
Scores=分数
Search=搜索
SearchAllTypes=搜索所有类型
SearchInActors=搜索参与者
SearchInCurrencies=在货币中搜索
SearchInDataQualitySystems=搜索数据质量系统
SearchInFlowProperties=搜索流特性
SearchInFlows=搜索流
Searching=搜索中...
SearchingForReferencedChanges=搜索所有已参考的变更
SearchingForUnits=搜索单位...
SearchInLCIACategories=在影响类别中搜索
SearchInLCIAMethods=搜索LCIA方法
SearchInLocations=搜索位置
SearchInParameters=搜索参数
SearchInProcesses=搜索
SearchInProductSystems=搜索生产系统
SearchInProjects=搜索方案
SearchInSocialIndicators=搜索社会指标
SearchInSources=搜索分数
SearchInUnitGroups=搜索单位群组
SearchParameters=搜索参数
SearchProviders=搜索提供者
SearchProvidersFor=搜索提供者
SearchRecipients=搜索接收者
SearchRecipientsFor=搜索接受者
SearchResults=搜索结果
Section=区块
Select=选择{0}
SelectADirectory=请选择目录
SelectAll=全选
SelectDataSets=选择数据集
SelectedParameterWasAlreadyAdded=所选择的参数已经加入 LCIA 方法
SelectImportFiles=选择导入的文件
SelectLanguageNoteMessage=直到重新启动时变更才会生效
SelectNext=选择下一个
SelectObjectPage_Description=请指定输出目录与选择 {0}你想要导出的
SelectPrevious=选择上一个
SelectProviders=选择供应者
SelectRecipients=选择接受者
SelectRepository=选择仓库
SelectTheExportFile=选择导出文件
SelectTheParameterYouWantToReferTo=选择你想要引用的参数
Semicolon=分号
ServerConfigurations=服务器设置
ServerUrl=服务器地址
SetAsQuantitativeReference=设置为定量参考
SetAsReferenceCurrency=设置成参考的货币
SetReferenceCurrencyQuestion=你想要设置货币成参考货币数据库中？
SetSankeyDiagramOptions=设置桑基图表选项
Settings=设置
SettingsOfTheSankeyDiagram=设置桑基图表
Show=显示
ShowComments=显示评论
ShowElementaryFlows=显示基本流
ShowExecutedUpdates=显示已执行更新
ShowFormulas=显示公式
ShowInHistory=显示历史
ShowInMap=显示于地图
ShowOutline=显示概要
ShowValues=显示数值
Showviews=显示视野(&V)
SimaProCSVImport=导入SimaPro CSV格式
SingleScore=单一分数
SingleScoreBarChart=单一分数长条图
SingleScoreTable=单一分数表格
SizeAfterCompression=压缩后大小
SizeBeforeCompression=压缩前大小
SocialAspect=社会观点
SocialAspects=社会观点
SocialAssessment=社会评估
SocialDataQualitySchema=社会质量格式
SocialIndicator=社会指标
SocialIndicators=社会指标
SocialSchema=社会格式
SolvingProblems=解决问题
SomeElementsAreNotSaved=产品系统引用的一些元素尚未保存。计算将不考虑这些元素。您现在要保存它们吗？
SomeParametersWereNotAdded=一些参数无法加入，可能加入无效的参数或是相同的名称
Source=来源
SourceFileDeleteQuestion=您确定删除此文件？
SourceFileOverwriteFileQuestion=数据库中已经有相同名称，你确定要覆写吗？
Sources=来源
South=南
StandardDeviation=标准偏差
StandardDeviationFormula=标准偏差(公式)
Start=开始
StartDate=开始日期
StartIPCInfo=点击“运行”按钮以启动IPC服务器。
StartIPCServer=启动一个IPC服务器
Statistics=统计资料
Status=状态
StopIPCInfo=IPC服务器正在运行。点击`停止`按钮或关闭此对话框以停止它。
StoreInventoryResult=存储库存结果
SubCategory=子类别
SubgroupByProcesses=过程子类别
Synonyms=同义
SystemDefinesUncertainties=系统不确定因素定义
SystemProcess=系统程序
SystemSaveProceedQuestion=生产系统必需被存储，你确定要执行吗？
Tab=Tab
TargetAmount=目标数量
Technology=技术
TechnologyDescription=技术内容
Telefax=传真
Telephone=电话
Test=测试
TestDistribution=测试分布
TexchnologyMatrix=技术矩阵
Text=文字
TextDropComponent_ToolTipText=从导航拖动选择的对象到文字栏位或点击去开启对话框
TextReference=文字参考
Theme=主题
ThisWillCompressTheDatabase=这将压缩数据库并释放未使用的空间。对于较大的数据库，这可能需要一段时间。
Time=时间
TimeAndAuthor=时间和作者
TimeDescription=时间内容
Title=标题
ToDirectory=到目录
ToFile=到文件
ToggleEditMode=切换编辑模式
ToggleMinimap=切换小地图
ToggleShowElementaryFlows=切换显示基本流
TotalAddedValue=总加入值
TotalNetcosts=总净成本
TotalRequirements=总需求
Tree=树状
TriangleDistribution=三角形分布
Type=类型
TypeOfRestriction=限制类型
Uncertainties=不确定因素
Uncertainty=不确定性
UncertaintyDistribution=不确定性分布
UniformDistribution=平均分布
Unit=单位
UnitAlreadyExistsInUnitGroup=单位已经在群组中{0}
UnitGroup=单位群组
UnitGroups=单位群组
UnitIsUsed=单位已使用在过程、影响评估方法或社会指标
UnitMappingPage_Description=导入过程时请选择流特性，如果它是新的单位需指定转换系数
UnitOfMeasurement=单位计算
UnitProcess=单位过程
Units=单位
UnitsAndFlowProperties=单位和流动特性
Unknown=未知的
Unmark=取消标记
UnsavedChanges=未保存的更改
Up=无条件进位
Update=更新
UpdateDatabase=数据库更新
UpdateDatabaseQuestion=选择的数据库需要更新. 请问需要开始更新吗?
UpdateMajorVersion=主要版本更新
UpdateMinorVersion=次要版本更新
UpdateReferenceCurrency=参考货币更新
UpdateWasAlreadyAddedOrExecuted=更新已被添加或执行
UpdatingProductSystem=生产系统更新
UpgradingRepositoryIndex=升级仓库索引
UpstreamInclDirect=上传包括.直接
UpstreamTotal=上传总数
UpToDate=更新-没有变化
URL=网址
Urn=URN
Usage=用法
UsageOf=用法
UsageType=使用类型
UseBrowserFeatures=使用浏览器功能
UsedInProcesses=用于过程
UseMaximumScoreForZeroValues=零值时使用最高评分
User=用户
Valid=有效
Validate=验证
ValidatingDatabase=验证数据库
Value=值
Variant=选项
VariantDescriptionTable=生产系统说明表格
Variants=比对生产系统
Vendor=供应商
Verifier=验证者
Version=版本
VersionNewer=较新版本
VeryHighRisk=较高风险
VeryLowRisk=较低风险
WaitingForServerToIndexDatasets=等待服务器索引数据集
Warning=警告
Warnings=警告
Waste=废物
WasteFlowSupplyReference=废物流供应产品系统的参考
Website=网站
WeightedArithmeticMean=加权算术平均值
WeightedAverage=加权平均
WeightedSquaredAverage=加权方均
Weighting=加权
WeightingFactor=加权因素
Welcome=欢迎
West=西
Window=视窗(&W)
With=与
WithPassword=使用密码
Year=年
Yes=是
ZipCode=邮政编码